//MAP CONVERTED BY dmm2tgm.py THIS HEADER COMMENT PREVENTS RECONVERSION, DO NOT REMOVE
"a" = (
/turf/open/genturf,
/area/ruin/beehive)
"z" = (
/turf/closed/mineral/random,
/area/template_noop)
"U" = (
/turf/closed/wall/material/wax,
/area/ruin/unpowered)

(1,1,1) = {"
z
z
z
z
z
z
z
z
z
z
z
z
z
z
z
z
z
z
z
z
z
z
z
z
z
z
z
z
z
z
"}
(2,1,1) = {"
z
z
z
z
z
z
U
U
U
U
U
U
U
z
z
z
z
z
z
z
z
z
z
z
z
z
z
z
z
z
"}
(3,1,1) = {"
z
z
z
z
z
U
U
a
a
a
a
a
U
z
z
z
z
z
z
U
U
U
U
z
z
z
z
z
z
z
"}
(4,1,1) = {"
z
z
z
z
z
U
a
a
a
a
a
a
U
U
z
z
z
U
U
U
a
a
U
U
U
z
z
z
z
z
"}
(5,1,1) = {"
z
z
z
z
z
U
a
a
a
a
a
a
a
U
z
z
U
U
a
a
a
a
a
a
U
U
z
z
z
z
"}
(6,1,1) = {"
z
z
z
z
z
U
a
a
a
a
a
a
a
U
z
U
U
a
a
a
a
a
a
a
a
U
U
z
z
z
"}
(7,1,1) = {"
z
z
z
z
z
U
a
a
a
a
a
a
a
U
U
U
a
a
a
a
a
a
a
a
a
a
U
U
z
z
"}
(8,1,1) = {"
z
z
z
z
z
U
a
a
a
a
a
a
a
a
U
a
a
a
a
a
a
a
a
a
a
a
a
U
z
z
"}
(9,1,1) = {"
z
z
z
z
z
U
U
a
a
a
a
a
a
a
a
a
a
a
a
a
a
a
a
a
a
a
a
U
z
z
"}
(10,1,1) = {"
z
z
z
z
z
z
U
a
a
a
a
a
a
a
a
a
a
a
a
a
a
a
a
a
a
a
U
U
z
z
"}
(11,1,1) = {"
z
z
z
z
z
z
U
a
a
a
a
a
a
a
a
a
a
a
a
a
a
a
a
a
a
a
U
z
z
z
"}
(12,1,1) = {"
z
z
z
z
z
z
U
a
a
a
a
a
a
a
a
a
a
a
a
a
a
a
a
a
a
a
U
z
z
z
"}
(13,1,1) = {"
z
z
z
z
z
z
U
a
a
a
a
a
a
a
a
a
a
a
a
a
a
a
a
a
a
a
U
z
z
z
"}
(14,1,1) = {"
z
z
z
z
z
U
U
a
a
a
a
a
a
a
a
a
a
a
a
a
a
a
a
a
a
a
U
z
z
z
"}
(15,1,1) = {"
z
z
z
z
U
U
a
a
a
a
a
a
a
a
a
a
a
a
a
a
a
a
a
a
a
a
U
z
z
z
"}
(16,1,1) = {"
z
z
U
U
U
a
a
a
a
a
a
a
a
a
a
a
a
a
a
a
a
a
a
a
a
a
U
U
z
z
"}
(17,1,1) = {"
z
z
U
a
a
a
a
a
a
a
a
a
a
a
a
a
a
a
a
a
a
a
a
a
a
a
a
U
z
z
"}
(18,1,1) = {"
z
z
U
a
a
a
a
a
a
a
a
a
a
a
a
a
a
a
a
a
a
a
a
a
a
a
a
U
z
z
"}
(19,1,1) = {"
z
z
U
a
a
a
a
a
a
a
a
a
a
a
a
a
a
a
a
a
a
a
a
a
a
a
a
U
z
z
"}
(20,1,1) = {"
z
z
U
a
a
a
a
a
a
a
a
a
a
a
a
a
a
a
a
a
a
a
a
a
a
a
a
U
z
z
"}
(21,1,1) = {"
z
z
U
a
a
a
a
a
a
a
a
a
a
a
a
a
a
a
a
a
a
a
a
a
a
a
a
U
z
z
"}
(22,1,1) = {"
z
z
U
a
a
a
a
a
a
a
a
a
a
a
a
a
a
a
a
a
a
a
a
a
a
a
a
U
z
z
"}
(23,1,1) = {"
z
z
U
a
a
a
a
a
a
a
a
a
a
a
a
a
a
a
a
a
a
a
a
a
a
a
a
U
z
z
"}
(24,1,1) = {"
z
z
U
a
a
a
a
a
a
a
a
a
a
a
a
a
a
a
a
a
a
a
a
a
a
a
U
U
z
z
"}
(25,1,1) = {"
z
z
U
U
a
a
a
a
a
a
a
a
a
a
a
a
a
a
a
a
a
a
a
a
a
U
U
z
z
z
"}
(26,1,1) = {"
z
z
z
U
U
a
a
a
a
a
a
U
U
U
U
U
U
U
U
a
a
a
a
a
U
U
z
z
z
z
"}
(27,1,1) = {"
z
z
z
z
U
U
a
U
U
U
U
U
z
z
z
z
z
z
U
U
U
U
U
U
U
z
z
z
z
z
"}
(28,1,1) = {"
z
z
z
z
z
U
U
U
z
z
z
z
z
z
z
z
z
z
z
z
z
z
z
z
z
z
z
z
z
z
"}
(29,1,1) = {"
z
z
z
z
z
z
z
z
z
z
z
z
z
z
z
z
z
z
z
z
z
z
z
z
z
z
z
z
z
z
"}
(30,1,1) = {"
z
z
z
z
z
z
z
z
z
z
z
z
z
z
z
z
z
z
z
z
z
z
z
z
z
z
z
z
z
z
"}
